1111111111111111111111111111111111111111
10000000000000000000000000001000C000E001
1000000001000C000P00000000001000C000E001
10000000C000000000E00000000C000000000E01
10000E00000100000C000000000C000000000E01
1000000000000000000WC000000C000000000E01
1000000001000C00500WE000000C000000000E01
10000000C000000000E001W1000C000000000E01
10000E0000000000WC0001WW100C000000000E11
1111111111111111111111111111111111111111
