111111111111111111111111111111111111111111111111
100000000010000000000000000000000000000000000001
1000000000100000000000000000000000000W0000000001
100000000000000000000000000000010000WW0000000001
1000000000000000000000000000000000000W0000000011
100000000000000000000001110000010000000000000001
10000000000000000E00CCCCC00000000000000000000011
10000000001000000000W000000000000000000000000001
100000000010000000000000000000000000000000000001
100000000000000000000000000000010000000000000001
100000000000000000000000000000000000010000000011
1000000000000000000P0001110000010000000000000001
100000000010000000000000000000000000000100000001
1000000000100000000000000000000000000W0000000001
100000000000000000000000000000010000000000000001
100000000000000000000000000000000000000000000011
100000000000000000000001110000010000000000000001
111111111111111111111111111111111111111111111111